.......####################............
.......####################............
.......####################............
.......####################............
.......####################............
.......####################............
.......####################............
.......####################............
.......####################............
.......####################............
.......####################............
.......####################............
.......####################............
.......####################............
.......####################............
.......####################............
.......####################............
.......####################............
..........# ............................
.......................................
.......................................
....................#..................
......................#................
.......................................
.......................................
.......................................
..###############......................
.......................................
.......................................
.......................................
.......................................
.......................................
.......................................
.......................................
.......................................
.......................................
.......................................
.......................................
.......................................
.......................................